1111111111111111111-
0000001100000011000-
0011001100110011001-
0011001100110011001-
0011001100110011001-
0011001100110011001-
0011001100110011001-
0011001100110011001-
0011001100110011001-
0011000000110000001
